{
  "width": 60,
  "height": 36,
  "grid": [
    "############################################################",
    "#..........................................................#",
    "#..............#..............#..............#.............#",
    "#..............#..............#..............#.............#",
    "#..........................................................#",
    "#..............#..............#..............#.............#",
    "#..............#..............#..............#.............#",
    "#..............#..............#..............#.............#",
    "######.###########.###########.###########.###########.#####",
    "#..............#..............#..............#.............#",
    "#..............#..............#..............#.............#",
    "#..............#..............#..............#.............#",
    "#..........................................................#",
    "#..............#..............#..............#.............#",
    "#..............#..............#..............#.............#",
    "#..............#..............#..............#.............#",
    "######.###########.###########.###########.###########.#####",
    "#..............#..............#..............#.............#",
    "#..............#..............#..............#.............#",
    "#..............#..............#..............#.............#",
    "#..........................................................#",
    "#..............#..............#..............#.............#",
    "#..............#..............#..............#.............#",
    "#..............#..............#..............#.............#",
    "######.###########.###########.###########.###########.#####",
    "#..............#..............#..............#.............#",
    "#..............#..............#..............#.............#",
    "#..............#..............#..............#.............#",
    "#..........................................................#",
    "#..............#..............#..............#.............#",
    "#..............#..............#..............#.............#",
    "#..............#..............#..............#.............#",
    "######.###########.###########.###########.###########.#####",
    "#..............#..............#..............#.............#",
    "#..........................................................#",
    "############################################################"
  ]
}
