{
  "width": 30,
  "height": 18,
  "grid": [
    "..............................",
    "..####...............####.....",
    "..#..#...............#..#.....",
    "..#..#....######.....#..#.....",
    "..#..#....#....#.....#..#.....",
    "..####....#....#.....####.....",
    "..........#....#..............",
    ".....###############..........",
    ".....#.............#..........",
    ".....#..####..####.#..........",
    ".....#..#..#..#..#.#....####..",
    ".....#..####..####.#....#..#..",
    ".....#.............#....#..#..",
    ".....###############....####..",
    "..............................",
    "..####....####....####....##..",
    "..#..#....#..#....#..#....#...",
    "..####....####....####....##.."
  ]
}
